###################
#P.........B......#
#.................#
#....G....^....G..#
#.................#
#....S....O....S..#
#.................#
#.........B....L..#
###################
