###################
#P......G...G.....#
#.................#
#..^^......^^.....#
#.................#
#..L.........L....#
#.................#
#..^^......^^.....#
#.................#
#......G....G...L.#
###################
