###################
#P............b...#
#.....####........#
#.................#
#..b..............#
#.....####........#
#.................#
#..b...........L..#
###################
