###################
#P...............#
#####.#####.######
#.....#.....#....#
#.###.#.###.#.##.#
#.#...#.#...#.#..#
#.#.###.#.###.#..#
#.#.....#.....#L.#
###################
