###################
#P.#.#.#.#.#.#.#L#
#...#.#.#.#.#.#..#
###.#.#.#.#.#.####
#...#.#.#.#.#.#..#
#.###.#.#.#.#.##.#
#.....#.#.#.#....#
###################
