###################
#P........B.......#
#.................#
#........B........#
#.................#
#........B........#
#.................#
#........B....L...#
###################
