###################
#P........S.......#
#.................#
#....B.....B......#
#.................#
#....G..O..G......#
#.................#
#....S..B..S..L...#
###################
