###################
#P.X.X.X.X.X.X.X.#
#.................#
#X.X.X.X.X.X.X.X.#
#.................#
#X.X.X.X.X.X.X.X.#
#.................#
#X.X.X.X.X.X.X.L.#
###################
