###################
#P...............#
#^^^^^^^^^^^^^^^^#
#..............G.#
#^^^^^^^^^^^^^^^^#
#..............G.#
#^^^^^^^^^^^^^^^^#
#..............L.#
###################
