###################
#P.b.b.b.b.b.b...#
#.................#
#b.b.b.b.b.b.b...#
#.................#
#b.b.b.b.b.b.b...#
#.................#
#...b.b.b.b.b..L.#
###################
