###################
#P..B..G..S..B..G.#
#.................#
#..^..O..^..O..^..#
#.................#
#G..B..S..G..B..S.#
#.................#
#..^..O..^..O..^..#
#.................#
#....B..G..S..L...#
###################
