###################
#P....#.....#.....#
#.....#.....#.....#
#.....#####.#.....#
#.................#
#..^^.............#
#.................#
#.....#####.#####.#
#.....#...L.#...#.#
###################
