###################
#P.......#........#
#........#........#
#........#........#
#........#........#
#........#........#
#........#........#
#........#....L...#
###################
