###################
#P..#..#..#..#..#.#
#....#..#..#..#...#
#..#..#..#..#..#..#
#....#..#..#..#...#
#..#..#..#..#..#..#
#....#..#..#..#..L#
###################
