###################
#P..#..^..#..O..#.#
#....#..#..#..#...#
#..#..O..#..^..#..#
#....#..#..#..#...#
#..^..#..O..#..^..#
#....#..#..#..#..L#
###################
